..............................................#######................................
..............................................#......................................
..............................................#......................................
..............................................#......................................
..............................................#......................................
..............................................#......................................
..........................................#############..............................
..........................................#...#.......#..............................
..........................................#...#.......#.........###########..........
..........................................#...#.......#.........#.........#..........
..........................................#...#.......#.........#.........#..........
..........................................#...#.......#.........#.........#..........
..................................#############.......#.........#.........#..........
..................................#.......#...........#.........#.........#..........
..................................#.......#...........#.........#.........#..........
..................................#.......#...........#.........#.........#..........
................................###########...........#.........#.........#..........
................................#.#...................#.........#.........#..........
................................#.#...................###########.........##########^
................................#.#..................................................
................................#.#..................................................
................................#.#..................................................
................................#.#..................................................
................................#.#..................................................
......................#############..................................................
......................#.........#....................................................
......................#.........###########..........................................
......................#...................#..........................................
......................#...................#..........................................
......................#...................#..........................................
......................#...................#..........................................
......................#...................#..........................................
......................#...................#..........................................
......................#...................#..........................................
......................###########.........#..........................................
................................#.........#..........................................
..............................#############..........................................
..............................#.#....................................................
..............................#.#....................................................
..............................#.#....................................................
..............................#.#....................................................
..............................#.#....................................................
###########...................#.#....................................................
#.........#...................#.#....................................................
#.........#...........###########....................................................
#.........#...........#.......#......................................................
#.........#...........#.......#......................................................
#.........#...........#.......#......................................................
#############.....#############......................................................
..........#.#.....#...#..............................................................
..........#.#.....#...#..............................................................
..........#.#.....#...#..............................................................
..........#.#.....#...#..............................................................
..........#.#.....#...#..............................................................
..........#############..............................................................
............#.....#..................................................................
............#.....#..................................................................
............#.....#..................................................................
............#.....#..................................................................
............#.....#..................................................................
............#######..................................................................
